84 50
193 340
3 3 3 3 3  5 5 3 3  3 3 3 5  5 5 5 3 3 3 3 3 3 3 3 3 3 3 3 3 3 3 3 3 3 3 3 3 3 3 3 3 3 3 3 3 3 3 3 3 3 3 3 3 3 5 5 5 5 5 5 3 3 3 3 3 3 3 3 3 5 5 5 5 3 3 3 3 3 3 3 3 3 3 3
3 3 3 3 3  7 7 4 3  3 3 3 7  7 7 7 3 3 3 3 3 3 3 3 3 3 3 3 3 4 4 4 4 4 4 4 4 4 3 3 3 3 3 3 3 3 3 3 3 3 3 3 3 3 7 7 7 7 7 7 3 3 3 3 3 3 3 3 3 7 7 7 7 3 3 3 3 3 3 3 3 3 3 3
3 4 4 4 4  0 0 0 3  3 3 4 0  0 0 0 4 3 3 3 3 3 3 3 3 3 3 3 4 1 1 1 1 1 1 1 1 1 4 4 4 3 3 3 3 3 4 4 4 3 3 3 4 4 0 0 0 0 0 0 3 3 3 3 4 4 4 4 4 0 0 0 0 4 4 4 4 4 4 4 4 4 4 4
3 0 0 0 0  0 0 0 4  4 4 0 0  0 0 0 0 4 3 3 3 3 3 3 3 3 3 3 0 0 0 0 0 0 0 0 0 0 1 1 1 3 3 3 3 4 2 2 2 4 4 4 2 2 0 0 0 0 0 0 3 3 3 4 0 0 0 0 0 0 0 0 0 0 8 5 5 5 5 5 5 5 5 5
3 0 0 0 0  0 0 0 0  0 0 0 0  0 0 0 0 0 3 3 3 3 3 3 3 3 3 3 1 1 1 1 1 1 1 1 0 0 1 1 1 4 4 4 4 2 2 2 2 2 2 2 2 2 0 0 0 0 0 0 3 3 3 0 0 0 0 0 0 0 0 0 0 0 8 5 5 5 5 5 5 5 5 5
3 0 0 0 0  0 0 0 0  0 0 0 0  0 0 0 0 0 4 3 3 3 3 3 3 3 3 3 0 0 0 0 0 0 0 0 0 0 1 1 1 1 1 1 1 2 2 2 2 2 2 2 2 2 0 0 0 0 0 3 3 3 3 0 0 0 0 0 0 0 0 0 0 0 8 5 5 5 5 5 5 5 5 5
3 0 0 0 0  0 0 0 0  0 0 0 0  0 0 0 0 0 0 3 3 3 3 3 3 3 3 3 1 1 1 1 1 1 1 1 0 0 1 1 1 1 1 1 1 2 2 2 2 2 2 2 2 2 0 0 0 0 0 3 3 3 3 0 0 0 0 0 0 0 0 0 0 0 8 5 5 5 5 5 5 5 5 5
3 0 0 0 0  0 0 0 0  0 0 0 0  0 0 0 0 0 0 3 3 3 3 3 3 3 3 3 3 0 0 0 0 0 0 0 0 0 0 0 3 3 3 3 3 3 3 2 2 2 2 2 2 2 0 0 0 0 0 3 3 3 3 0 0 0 0 0 0 0 0 0 0 0 8 5 5 3 3 3 3 3 3 3
3 0 0 0 0  0 0 0 0  0 0 0 0  0 0 0 0 0 0 3 3 3 3 3 3 3 3 3 3 3 3 3 3 3 3 3 0 0 0 0 4 3 3 3 3 3 3 2 2 2 2 2 2 2 0 0 0 0 0 3 3 3 3 0 0 0 0 0 0 0 0 0 0 3 3 3 3 3 3 3 3 3 3 3
3 0 0 0 0 0 10 6 11 0 0 0 0  0 0 0 0 0 0 4 3 3 3 3 3 3 3 3 3 3 3 3 3 3 3 3 0 0 0 0 0 3 3 3 3 3 3 3 3 2 2 2 2 2 0 0 0 0 0 3 3 3 3 3 0 0 0 0 0 0 0 0 0 3 3 3 3 3 3 3 3 3 3 3
3 0 0 0 0 0 8 5 9   0 0 0 0  0 0 0 0 0 0 0 4 3 3 4 4 4 3 3 3 3 3 3 3 3 4 4 0 0 0 0 0 3 3 3 3 3 3 3 3 3 3 3 3 3 3 3 0 0 0 4 4 3 3 3 3 3 3 3 3 0 0 0 3 3 3 3 3 3 3 3 3 3 3 3
3 0 0 0 0 0 12 7 13 0 0 0 0  0 0 0 0 0 0 0 0 4 4 0 0 0 3 3 3 3 3 3 3 3 0 0 0 0 0 0 0 4 4 3 3 3 3 3 3 3 3 3 3 3 3 3 0 0 0 0 0 4 3 3 3 4 4 4 4 0 0 0 4 3 3 3 3 3 3 3 3 3 3 3
3 0 0 0 0  0 0 0 0  0 0 0 3  3 0 0 0 0 0 0 0 0 0 0 0 0 3 3 3 3 3 3 3 3 0 0 0 0 0 0 0 0 0 3 3 3 3 3 3 3 3 3 3 3 3 3 0 0 0 0 0 0 4 4 4 0 0 0 0 0 0 0 0 4 4 4 4 4 4 4 4 4 4 4
3 3 3 0 0  0 0 0 0  0 0 0 3  3 0 0 0 0 0 0 0 0 0 0 0 0 3 3 3 3 3 3 3 3 3 3 3 3 0 0 0 0 0 3 3 3 3 3 3 3 3 3 3 3 3 3 0 0 0 0 0 0 0 0 0 0 0 0 0 0 0 0 0 0 8 5 5 5 5 5 5 5 5 5
3 3 3 0 0  0 0 0 0  0 0 3 3  3 0 0 0 0 0 0 0 0 0 0 0 0 3 3 3 3 3 3 3 3 3 3 3 3 3 3 3 0 0 3 3 3 3 3 3 3 3 3 3 3 3 3 0 0 0 0 0 0 0 0 0 0 0 0 0 0 0 0 0 0 8 5 5 5 5 5 5 5 5 5
3 3 3 3 6  6 6 6 6  6 6 3 3  3 0 0 0 0 0 0 0 0 0 0 0 0 3 3 3 3 3 4 4 4 4 3 3 3 3 3 4 0 0 4 4 3 3 3 3 4 4 4 4 3 3 3 0 0 0 0 0 0 0 0 0 0 0 0 0 0 0 0 0 0 8 5 5 5 5 5 5 5 5 5
3 3 3 3 5  5 5 5 5  5 5 3 3  3 0 0 0 0 0 0 0 0 0 0 0 0 3 3 3 3 3 0 0 0 0 4 4 4 4 4 0 0 0 0 0 4 4 4 4 0 0 0 0 3 3 3 0 0 0 0 0 0 0 0 0 0 0 0 0 0 0 0 0 0 8 5 5 5 5 5 5 5 5 5
3 3 3 3 5  5 5 5 5  5 5 3 3  3 0 0 0 0 0 0 0 0 0 0 0 0 3 3 3 3 4 0 0 0 0 0 0 0 0 0 0 0 0 0 0 0 0 0 0 0 0 0 0 4 4 4 0 0 0 0 0 0 0 0 0 0 0 0 0 0 0 0 0 0 8 5 5 5 5 5 5 5 3 3
3 3 3 3 5  5 5 5 5  5 5 3 3  3 0 0 0 0 0 0 0 0 3 3 3 3 3 3 3 3 0 0 0 0 0 0 0 0 0 0 0 0 0 0 0 0 0 0 0 0 0 0 0 0 0 0 0 0 0 0 0 0 0 0 0 0 0 0 0 0 0 3 3 3 3 3 3 3 3 3 3 3 3 3
3 3 3 3 5  5 5 5 5  5 5 3 3  3 0 0 0 0 0 0 0 3 3 3 3 3 3 3 3 3 0 0 0 0 3 3 3 0 0 0 0 0 0 0 0 0 0 0 0 0 0 0 0 0 0 0 0 0 0 0 0 0 0 0 0 0 0 0 0 3 3 3 3 3 3 3 3 3 3 3 3 3 3 3
3 3 3 3 5  5 5 5 5  5 3 3 3  3 0 0 0 0 0 3 3 3 3 3 3 3 3 3 3 4 0 0 0 0 3 3 3 3 0 0 0 0 0 0 0 0 0 0 0 0 0 0 0 0 0 0 0 0 0 0 0 0 0 0 0 0 0 3 3 3 3 3 3 3 3 3 3 3 3 3 3 5 5 5
3 3 3 3 5  5 5 5 5  3 3 3 3  3 0 0 0 0 0 3 3 3 3 3 3 3 3 4 4 0 0 0 0 0 4 4 3 3 0 0 3 3 3 3 0 0 0 0 0 0 0 0 3 3 0 0 0 0 0 0 0 0 0 0 0 0 4 4 4 4 4 3 3 3 3 3 3 3 3 3 4 5 5 5
3 3 3 3 3  5 5 5 3  3 3 3 3  4 0 0 0 0 0 4 3 3 3 3 4 4 4 0 0 0 0 0 0 0 0 0 4 4 0 0 4 4 3 3 3 3 0 0 0 0 0 0 3 3 0 0 0 0 0 0 0 0 0 0 0 0 0 0 0 0 0 4 4 4 4 4 4 4 4 4 5 5 5 5
3 3 3 3 3  3 3 3 3  3 3 3 3  0 0 0 0 0 0 0 4 4 4 4 0 0 0 0 0 0 0 0 0 0 0 0 0 0 0 0 0 0 3 3 3 3 3 3 0 0 0 3 3 3 3 0 0 0 3 3 3 3 0 0 0 0 0 0 0 0 0 0 0 0 8 5 5 5 5 5 5 5 5 5
3 3 3 3 3  3 3 3 3  3 3 3 3  0 0 0 0 0 0 0 0 0 0 0 0 0 0 0 0 0 0 0 0 0 0 0 0 0 0 3 3 3 3 3 3 3 3 3 3 3 3 3 3 3 3 3 3 3 3 3 3 3 3 3 0 0 0 0 0 0 0 0 0 0 8 5 5 5 5 5 5 5 5 5
3 3 3 3 3  3 3 3 3  3 3 3 3  0 0 0 0 0 0 0 0 0 0 0 0 0 0 0 0 0 0 0 0 0 0 0 0 0 0 4 4 3 3 3 3 4 4 4 4 3 3 3 3 3 3 3 3 4 4 4 3 3 3 3 3 3 0 0 0 0 0 0 0 0 8 5 5 5 5 5 5 5 5 5
3 3 3 3 3  3 3 3 3  3 3 3 3  0 0 0 0 0 0 0 0 0 0 0 0 0 0 0 0 0 0 0 0 0 0 0 0 0 0 0 0 4 4 4 4 0 0 0 0 4 3 3 3 3 3 3 3 0 0 0 4 4 4 4 4 4 0 0 0 0 0 0 0 0 8 5 5 5 5 5 5 5 5 5
3 3 3 3 3  3 3 3 3  3 3 4 4  0 0 0 0 0 0 0 0 0 0 0 0 0 0 0 0 0 0 0 0 0 0 0 0 0 0 0 0 0 0 0 0 0 0 0 0 0 4 4 4 4 3 3 4 0 0 0 0 0 0 0 0 0 0 0 0 0 0 0 0 0 8 5 5 5 5 5 5 5 5 5
3 3 3 4 4  4 4 4 4  4 4 0 0  0 0 0 0 0 0 0 0 0 0 0 0 0 0 0 0 0 0 0 0 0 0 0 0 0 0 0 0 0 0 0 0 0 0 0 0 0 0 0 0 0 4 4 0 0 0 0 0 0 0 0 0 0 0 0 0 0 0 0 0 0 8 5 5 5 5 5 5 3 3 3
3 3 3 0 0  0 0 0 0  0 0 0 0  0 0 0 0 0 0 0 0 0 0 0 0 0 0 0 0 0 0 0 0 0 0 0 0 0 0 0 0 0 0 0 0 0 0 0 0 0 0 0 0 0 0 0 0 0 0 0 0 0 0 0 0 0 0 0 0 0 0 0 0 0 8 5 5 5 5 5 3 3 3 3
3 3 3 0 0  0 0 0 0  0 0 0 0  0 0 0 0 0 0 0 3 3 3 3 3 3 3 3 3 0 0 0 0 0 0 0 0 0 0 0 0 0 0 0 0 0 0 0 0 0 0 0 0 0 0 0 0 0 0 0 0 0 0 0 0 0 0 0 0 0 0 0 0 0 8 5 5 5 3 3 3 3 3 3
3 3 3 3 0  0 0 3 3  3 3 3 3  3 0 0 0 0 0 3 3 3 3 3 3 3 4 4 4 3 3 0 0 0 0 0 0 0 0 0 0 0 3 3 3 3 0 0 0 0 0 3 3 3 3 3 0 0 0 0 0 0 0 0 0 0 0 0 0 0 0 0 0 0 8 5 5 5 3 3 3 3 3 3
3 3 3 3 0  0 0 4 3  3 3 3 3  3 3 3 3 3 3 3 3 3 3 3 3 3 5 5 5 3 3 3 0 0 0 0 0 0 0 0 3 3 3 3 3 3 3 0 0 0 0 4 4 4 3 3 0 0 0 0 0 0 0 0 0 0 0 0 0 0 0 0 0 0 8 5 5 5 3 3 3 3 3 3
3 3 3 3 3  0 0 0 3  3 3 3 3  3 3 3 3 3 3 3 3 4 4 4 3 3 5 5 5 3 3 3 0 0 0 0 0 0 0 3 3 3 3 3 3 3 3 0 0 0 0 0 0 0 4 4 3 3 0 0 0 0 0 0 0 0 0 0 0 0 0 0 0 0 8 5 5 3 3 3 4 4 4 4
3 3 3 3 3  3 0 0 3  3 3 3 3  3 4 4 4 4 4 4 4 0 0 0 3 3 3 3 3 3 3 3 0 0 0 0 0 3 3 3 3 3 3 3 3 3 3 0 0 0 0 0 0 0 0 0 3 3 0 0 0 0 0 0 0 0 0 0 0 0 0 0 0 0 8 5 5 4 4 4 5 5 5 5
3 3 3 3 3  3 0 0 4  3 3 3 3  3 0 0 0 0 0 0 0 0 0 0 4 4 4 3 3 3 3 3 3 3 3 3 3 3 3 3 3 3 3 3 3 4 4 0 0 0 0 0 0 0 0 0 3 3 0 0 0 0 0 0 0 0 0 0 0 0 0 0 0 0 8 5 5 5 5 5 5 5 5 5
3 3 3 3 4  4 0 0 0  4 4 4 4  4 0 0 0 0 0 0 0 0 0 0 0 0 0 3 3 3 3 3 3 3 3 3 3 3 3 4 4 4 3 3 3 0 0 0 0 0 0 0 0 0 0 3 3 3 3 3 0 0 0 0 0 0 0 3 3 3 3 0 0 0 8 5 5 5 5 5 5 5 5 5
3 3 4 4 0  0 0 0 0  0 0 0 0  0 0 0 0 0 0 0 0 0 0 0 0 0 0 3 3 3 3 3 3 3 3 3 3 3 4 0 0 0 3 3 4 0 0 0 0 0 0 0 0 0 0 3 3 3 3 3 0 0 0 0 0 3 3 3 3 3 3 0 0 0 8 5 5 5 5 5 5 5 5 5
3 3 0 0 0  0 0 0 0  0 0 0 0  0 0 0 0 0 0 0 0 0 0 0 0 0 0 3 3 3 3 3 3 3 3 3 3 3 0 0 0 0 4 4 0 0 0 0 0 0 0 0 0 0 3 3 3 3 3 3 0 0 0 0 3 3 3 3 3 4 4 0 0 0 8 5 5 5 5 5 5 5 5 5
3 3 3 3 3  3 3 3 3  3 3 3 3  0 0 0 0 0 0 0 0 0 0 0 0 0 0 3 3 3 4 4 3 3 3 3 4 4 0 0 0 0 0 0 0 0 0 0 0 0 0 3 3 3 3 3 4 4 4 4 0 0 3 3 3 3 3 4 4 0 0 0 0 0 8 5 5 5 5 5 5 5 5 5
3 3 3 3 3  3 3 3 3  3 3 3 3  0 0 0 0 0 0 0 0 0 0 0 0 0 0 4 4 4 0 0 4 4 4 4 0 0 0 0 0 0 0 0 0 0 0 0 3 3 3 3 3 3 3 3 0 0 0 0 0 0 4 4 4 3 3 0 0 0 0 0 0 0 8 5 5 5 5 5 5 5 5 5
3 3 3 3 3  3 3 3 3  3 4 3 3  0 0 0 0 0 0 0 0 0 0 0 0 0 0 0 0 0 0 0 0 0 0 0 0 0 0 0 0 0 0 0 0 0 0 0 3 3 3 4 4 4 4 4 0 0 0 0 0 0 0 0 0 3 3 0 0 0 0 0 0 0 8 5 5 5 5 5 5 5 5 5
3 3 3 3 3  3 4 4 4  4 0 3 3  3 0 0 0 0 0 0 0 0 0 0 0 0 0 0 0 0 0 0 0 0 0 0 0 0 0 0 0 0 0 0 0 0 0 0 4 4 4 0 0 0 0 0 0 0 0 0 0 0 0 0 0 3 3 3 0 0 0 0 0 0 8 5 5 5 5 5 5 5 5 5
3 3 3 3 3  4 0 0 0  0 0 4 4  4 0 0 0 0 0 0 0 0 0 0 0 0 0 0 3 3 3 3 0 0 0 0 0 0 0 0 0 0 0 0 0 0 0 0 0 0 0 0 0 0 0 0 0 0 0 0 0 0 0 0 0 3 3 3 0 0 0 0 0 0 8 5 5 5 5 5 5 5 5 5
3 3 3 3 4  0 0 0 0  0 0 0 0  0 0 0 0 0 0 0 0 0 0 0 0 0 0 0 3 3 3 3 0 0 0 0 0 0 0 0 0 0 0 0 0 0 0 0 0 0 0 0 0 0 0 0 0 0 0 0 0 0 0 0 3 3 3 3 0 0 0 0 0 0 8 5 5 5 5 5 5 5 5 5
3 3 3 3 0  0 0 0 0  0 0 0 0  0 0 0 0 0 0 0 0 0 0 0 0 0 0 0 3 3 3 3 3 0 0 0 0 0 0 0 0 0 0 0 0 0 0 0 3 3 0 0 0 0 0 0 0 0 0 0 0 0 0 0 3 3 3 3 0 0 0 0 0 0 8 5 5 5 5 5 5 5 5 5
3 3 3 3 0  0 0 0 0  0 0 0 0  0 0 0 0 0 0 0 0 0 0 0 0 0 0 0 3 3 3 3 3 0 0 0 0 0 0 0 0 0 0 0 0 0 0 3 3 3 3 0 0 0 0 0 0 0 0 0 0 0 0 3 3 3 3 3 3 3 0 0 0 0 8 5 5 5 5 5 5 5 5 5
3 3 3 3 0  0 0 0 0  0 0 0 3  3 3 3 3 3 3 3 3 0 0 0 0 0 0 3 3 3 3 3 3 3 0 0 0 0 0 0 0 0 3 3 3 0 0 3 3 3 3 3 3 0 0 0 0 0 0 0 0 3 3 3 3 3 3 3 3 3 3 3 0 0 8 5 5 5 5 5 5 5 5 5
3 3 3 3 6  6 6 6 6  6 6 3 3  3 3 3 3 3 3 3 3 3 3 6 6 6 6 3 3 3 3 3 3 3 3 3 3 3 3 0 0 3 3 3 3 3 3 3 3 3 3 3 3 3 3 3 0 0 0 0 0 3 3 3 3 3 3 3 3 3 3 3 3 3 3 3 3 5 5 5 5 5 5 5
3 3 3 3 5  5 5 5 5  5 5 3 3  3 3 3 3 3 3 3 3 3 3 5 5 5 5 3 3 3 3 3 3 3 3 3 3 3 3 3 3 3 3 3 3 3 3 3 3 3 3 3 3 3 3 3 3 3 3 3 3 3 3 3 3 3 3 3 3 3 3 3 3 3 3 3 3 5 5 5 5 5 5 5